%%%%%%%%%%%%%%%%%%%%%%%%%%%%%%%%%%%%%%
%P%  .%.%.%   %.%      %.%%%     %   %
%P% %.% %          %%% %     % % % % %
% % % %   %%% %%% %%     %%%%% %.% % %
% % % % % %.%  .%.%  %%% %     %.% % %
% % % % % % % %%%%%  %.%   %%% %%% % %
% % %   %.% % %        % % %.%   % % %
% % %%% %%%   %.%  %%%%% % % % % % % %
% % %.%     % %%%  %.%.  %.% % % % % %
% % %.% %%%%%     %% %%% %%%   % % % %
% % % % %     % %%%          % %.% %G%
%   %     %%%.%      %.%   %.%.%.  %G%
%%%%%%%%%%%%%%%%%%%%%%%%%%%%%%%%%%%%%%