%%%%%%%%%%%%%%%%%%%%%%%%%%%%%%%%%%%%
%               P%%                %
% %%%%%%%%%%%%%% %%%%%%%%%%%%%%%%% %
% %.........   %   ..............% %
% %........  %.%%%%%%%%.%%% %%.%%% %
% %%%%.%%%%% %...  .%.....% %....% %
%  ....%P%%%.%%%.  .......% %....  %
%  ....% %.......  .%%%.%%%G%....  %
% %....% %.....%.  ...% %%%%%.%%%% %
% %%% %% %%%.%%%%%%%%.%  ........% %
% %..............   %   .........% %
% %%%%%%%%%%%%%%%%% %%%%%%%%%%%%%% %
%               G%%G               %
%%%%%%%%%%%%%%%%%%%%%%%%%%%%%%%%%%%%