%%%%%%%%%%%%%%%%%%%%%%%%%%%%%%%%%%%%%%%%
%   %   %. %.%.%       %     %.%.%   %G%
% % % % %%       %%  %   %%%   %.% % %G%
% % % % %. % %%%    %%%% .%..% % % % % %
% % % % %% % ..% %   %   %%%%% % % % % %
% % % %    %%%%% %%%   %%%.% o % % % % %
% % % %% % ....  %.%%%       %   % % % %
% % % %. %%.%%%%        %.%%%%  %% % % %
% % % %%  %%%%.%        %%%%.%% .% % % %
% % % %   %       %%%.%  .... % %% % % %
% % % % % o %.%%%   %%% %%%%%    % % % %
% % % % % %%%%%   %   % %.. % %% % % % %
% % % % % %..%. %%%%    %%% % .% % % % %
%P% % %.%   %%%   %  %%       %% % % % %
%P%   %.%.%     %       %.%.% .%   %   %
%%%%%%%%%%%%%%%%%%%%%%%%%%%%%%%%%%%%%%%%
