%%%%%%%%%%%%%%%%%%%%%%%%%%%%%%%%
%   %.%%.%   %           %.%.%G%
% % %      %    %%%% %%%   %.%G%
% % % %  %%% %       .%..%   % %
% % % %  ..% %.%%%% %%%%%% % % %
% % % %%%%%% %%%%.% %..  % % % %
% %   %..%.       % %%%  % % % %
%P%.%   %%% %%%%    %      % % %
%P%.%.%           %   %.%%.%   %
%%%%%%%%%%%%%%%%%%%%%%%%%%%%%%%%
