%%%%%%%%%%%%%%%%%%%%
%....%...  ...%....%
%.%%.%.%%  %%.%.%%.%
%.%....      ....%.%
%.%%.%.%%%%%%.%.%%.%
%......      ......%
%.%%...%%  %%...%%.%
%.%..%...  ...%..%.%
%.%%.%.%%%%%%.%.%%.%
%......      ......%
% %%%%%%%%%%%%%%%% %
%       P%%G       %
%%%%%% %%%%%% %%%%%%
%%%%%%  P%%G  %%%%%%
%%%%%%%%%%%%%%%%%%%%
