%%%%%%%%%%%%%%%%%%%%%%%%%%%%%%%%%%%%%%%%%%%%
%     .   ..    ..        ..    ..   .     %
% % % %%%%%%%%%%%%%% %% %%%%%%%%%%%%%% % % %
% % % .  .  .  .  .  %%  .  .  .  .  . % % %
%P%.% %%%%%%%%%%%%%% %% %%%%%%%%%%%%%% %.%G%
%%%%% .  .  .  .  .      .  .  .  .  . %%%%%
%o .  %%%%..%%%%..%%%%%%%%..%%%%..%%%%    o%
%%%%% .  .  .  .  .      .  .  .  .  . %%%%%
%P%.% %%%%%%%%%%%%%% %% %%%%%%%%%%%%%% %.%G%
% % % .  .  .  .  .  %%  .  .  .  .  . % % %
% % % %%%%%%%%%%%%%% %% %%%%%%%%%%%%%% % % %
%     .   ..    ..        ..    ..   .     %
%%%%%%%%%%%%%%%%%%%%%%%%%%%%%%%%%%%%%%%%%%%%